10 10
1111111111
1000001001
1000001001
1000000001
1110000001
1000000001
1000010001
1000010001
1000010001
1111111111
