20 20
11111111111111111111
10000010001000000001
10000010001000000001
10000000001000000001
11100000001000000001
11000000000000000001
11000000000000000001
11000000000000000001
10000100011111111111
10000100001000000001
10000100001000000001
10000010001000000001
10000010001000000001
10000000001000000001
11100000001000000001
11000000000000000001
10000100011111111111
10000100001000000001
10000100001000000001
11111111111111111111
